##########
#x**x x  #
#***xxx* #
# x*xx*xx#
##########
